|################################################################################|
|#''''''''''''''''''''''''''''''''''''''''''''''''''''''''''''''''''''''''''''''#|
|#''''''    '''''''''''    '''''''''''    '''''''''''    '''''''''''    ''''''''#|
|#'''''      '''''''''      '''''''''      '''''''''      '''''''''      '''''''#|
|#''''        '''''''        '''''''        '''''''        '''''''        ''''''#|
|#'''          '''''          '''''          '''''          '''''          '''''#|
|#''    ''''    '''    ''''    '''    ''''    '''    ''''    '''    ''''    ''''#|
|#'    ''''''    '    ''''''    '    ''''''    '    ''''''    '    ''''''    '''#|
|#    ''''''''       ''''''''       ''''''''       ''''''''       ''''''''       |
|#    ''''''''       ''''''''       ''''''''       ''''''''       ''''''''       |
|#    ''''''''       ''''''''       ''''''''       ''''''''       ''''''''       |
|#    ''''''''       ''''''''       ''''''''       ''''''''       ''''''''       |
|#'    ''''''    '    ''''''    '    ''''''    '    ''''''    '    ''''''    '''#|
|#''    ''''    '''    ''''    '''    ''''    '''    ''''    '''    ''''    ''''#|
|#'''          '''''          '''''          '''''          '''''          '''''#|
|#''''        '''''''        '''''''        '''''''        '''''''        ''''''#|
|#'''''      '''''''''      '''''''''      '''''''''      '''''''''      '''''''#|
|#''''''    '''''''''''    '''''''''''    '''''''''''    '''''''''''    ''''''''#|
|#''''''''''''''''''''''''''''''''''''''''''''''''''''''''''''''''''''''''''''''#|
|################################################################################|