|################################################################################|
|#''''''''''''''''''''''''''''''''''''''''''''''''''''''''''''''''''''''''''''''#|
|#''''''''''''''''''''''''''''''''''''''''''''''''''''''''''''''''''''''''''''''#|
|#''''''''''''########''''''''''''''''''''''''''''''''''''''########''''''''''''#|
|#''''''''''''########''''''''''''''''''''''''''''''''''''''########''''''''''''#|
|#''''''''''''########''''''''''''''''''''''''''''''''''''''########''''''''''''#|
|#''''''''''''########''''''''''''''''''''''''''''''''''''''########''''''''''''#|
|#''''''''''''''''''''''''''''''''''''''''''''''''''''''''''''''''''''''''''''''#|
|#''''''''''''''''''''''''''''''''''''''''''''''''''''''''''''''''''''''''''''''#|
|#''''''''''''####################              ####################''''''''''''#|
|#''''''''''''                                                      ''''''''''''#|
|#''''''''''''                                                      ''''''''''''#|
|#''''''''''''####################              ####################''''''''''''#|
|#'''''''''''''''''''''''''''''''#              #'''''''''''''''''''''''''''''''#|
|#'''''''''''''''''''''''''''''''#              #'''''''''''''''''''''''''''''''#|
|#'''''''''''''''''''''''''''''''#              #'''''''''''''''''''''''''''''''#|
|#'''''''''''''''''''''''''''''''#              #'''''''''''''''''''''''''''''''#|
|#'''''''''''''''''''''''''''''''                '''''''''''''''''''''''''''''''#|
|#'''''''''''''''''''''''''''''''                '''''''''''''''''''''''''''''''#|
|################################                ################################|