|################################################################################|
|#''''''''''''#'''''''''''' ''''''''''''#''''''''''''              '''''''''''''#|
|#'''''''''''#'#'''''''''' ' ''''''''''#'#''''''''''                ''''''''''''#|
|#''''''''''#'''#'''''''' ''' ''''''''#'''#'''''''''   ''''''''''   ''''''''''''#|
|#'''''''''#'''''#'''''' ''''' ''''''#'''''#''''''''  ''''''''''''  ''''''''''''#|
|#''''''''#'''''''#'''' ''''''' ''''#'''''''#'''''''  ''''''''''''  '##########'#|
|#'''''''#'''''''''#'' ''''''''' ''#'''''''''#''''''  ''''''''''''  '#        #'#|
|#''''''#'''''''''''# ''''''''''' #'''''''''''#'''''  ''''''''''''  '#        #'#|
|                                                      ''''''''''             #'#|
|                                                                             #'#|
|                                                                             #'#|
|                                                      ''''''''''             #'#|
|#''''''#'''''''''''# ''''''''''' #'''''''''''#'''''  ''''''''''''  '#        #'#|
|#'''''''#'''''''''#'' ''''''''' ''#'''''''''#''''''  ''''''''''''  '#        #'#|
|#''''''''#'''''''#'''' ''''''' ''''#'''''''#'''''''  ''''''''''''  '##########'#|
|#'''''''''#'''''#'''''' ''''' ''''''#'''''#''''''''  ''''''''''''  ''''''''''''#|
|#''''''''''#'''#'''''''' ''' ''''''''#'''#'''''''''   ''''''''''   ''''''''''''#|
|#'''''''''''#'#'''''''''' ' ''''''''''#'#''''''''''                ''''''''''''#|
|#''''''''''''#'''''''''''' ''''''''''''#''''''''''''              '''''''''''''#|
|################################################################################|