|################################################################################|
|#''''''''''''''''''''#                  '''''''''''''''''''''''''''''''''''''''#|
|#''''''''''''''''''''#                  '''''''''''''''''''''''''''''''''''''''#|
|#''''''''''''''''''''#                  '''''''''''''''''''''''''''''''''''''''#|
|#''''''''''''''''''''#                  ''''''''''''''''''''### #############''#|
|#''''''''''''''''''''#    ''''''''''    ''''''''''''''''''''#     #         #''#|
|#''''''''''''''''''''#    ''''''''''    ''''''''''''''''''''#     #         #''#|
|#''''''''''''''''''''#    ''''''''''    ''''''''''''''''''''#     #         #''#|
|                          ''''''''''    ''''            ''''#               #''#|
|                          ''''''''''    ''''            ''''#               #''#|
|                          ''''''''''    ''''            ''''#               #''#|
|                          ''''''''''    ''''            ''''#               #''#|
|#''''''''''''''''''''#''''''''''''''    ''''    ''''''''''''#     #         #''#|
|#''''''''''''''''''''#''''''''''''''    ''''    ''''''''''''#     #         #''#|
|#''''''''''''''''''''#''''''''''''''    ''''    ''''''''''''#     #         #''#|
|#''''''''''''''''''''#''''''''''''''            ''''''''''''### #############''#|
|#''''''''''''''''''''#''''''''''''''            '''''''''''''''''''''''''''''''#|
|#''''''''''''''''''''#''''''''''''''            '''''''''''''''''''''''''''''''#|
|#''''''''''''''''''''#''''''''''''''            '''''''''''''''''''''''''''''''#|
|################################################################################|