|################################                ################################|
|#'''''''''''''''''''''''''''''''                '''''''''''''''''''''''''''''''#|
|#'''''''''''''''''''''''''''''''                '''''''''''''''''''''''''''''''#|
|#'''''''''''''''''''''''''''''''                '''''''''''''''''''''''''''''''#|
|#'''''''''''''''''''''''''''''''                '''''''''''''''''''''''''''''''#|
|#'''''''''''''''''''''''''''''''                '''''''''''''''''''''''''''''''#|
|#'''''''''''''''''''''''''''''''                '''''''''''''''''''''''''''''''#|
|#'''''''''''''''''''''''''''''''                '''''''''''''''''''''''''''''''#|
|                                                                                |
|                                                                                |
|                                                                                |
|                                                                                |
|#''''''''''''''''''''''''''##########################''''''''''''''''''''''''''#|
|#''''''''''''''''''''''''''##########################''''''''''''''''''''''''''#|
|#''''''''''''''''''''''''''##########################''''''''''''''''''''''''''#|
|#''''''''''''''''''''''''''##########################''''''''''''''''''''''''''#|
|#''''''''''''''''''''''''''##########################''''''''''''''''''''''''''#|
|#''''''''''''''''''''''''''##########################''''''''''''''''''''''''''#|
|#''''''''''''''''''''''''''##########################''''''''''''''''''''''''''#|
|################################################################################|