|################################                ################################|
|#'''''''''''''''''''''''''''''''                '''''''''''''''''''''''''''''''#|
|#'''''''''''''''''''''''''''''''                '''''''''''''''''''''''''''''''#|
|#'''''''''''''''''''''''''''''''                '''''''''''''''''''''''''''''''#|
|#'''''''''''''''''''''##########                ##########'''''''''''''''''''''#|
|#'''''''''''''''''''''#                                  #'''''''''''''''''''''#|
|#'''''''''''''''''''''#                                  #'''''''''''''''''''''#|
|########       ########                                  ########       ########|
|                                    ''''''''                                    |
|                                   ''''''''''                                   |
|                                   ''''''''''                                   |
|                                    ''''''''                                    |
|########       ########                                  ########       ########|
|#'''''''''''''''''''''#                                  #'''''''''''''''''''''#|
|#'''''''''''''''''''''#                                  #'''''''''''''''''''''#|
|#'''''''''''''''''''''##########                ##########'''''''''''''''''''''#|
|#'''''''''''''''''''''''''''''''                '''''''''''''''''''''''''''''''#|
|#'''''''''''''''''''''''''''''''                '''''''''''''''''''''''''''''''#|
|#'''''''''''''''''''''''''''''''                '''''''''''''''''''''''''''''''#|
|################################                ################################|