|################################################################################|
|#''''''''''''''''''''''''''''''''''''''''''''''''''''''''''''''''''''''''''''''#|
|#''''''''''''''''''''''''''''''''''''''''''''''''''''''''''''''''''''''''''''''#|
|#''''''''''''##############''''''''''''##############''''''''''''''''''''''''''#|
|#''''''''''''#            #''''''''''''#            #''''''''''''''''''''''''''#|
|#''''''''''''#            #''''''''''''#            #''''''''''''''''''''''''''#|
|#''''''''''''#            #####''''#####            ###########''''''###########|
|#''''''''''''####      ####            ####      ####                          #|
|#'''''''''''''#                                                                 |
|#''''''''''''''                                                                 |
|#''''''''''''''                                                                 |
|#'''''''''''''#                                                                 |
|#''''''''''''####      ####            ####      ####                          #|
|#''''''''''''#            #####''''#####            ###########''''''###########|
|#''''''''''''#            #''''''''''''#            #''''''''''''''''''''''''''#|
|#''''''''''''#            #''''''''''''#            #''''''''''''''''''''''''''#|
|#''''''''''''##############''''''''''''##############''''''''''''''''''''''''''#|
|#''''''''''''''''''''''''''''''''''''''''''''''''''''''''''''''''''''''''''''''#|
|#''''''''''''''''''''''''''''''''''''''''''''''''''''''''''''''''''''''''''''''#|
|################################################################################|